ALABAMA|AL|US
ALASKA|AK|US
AMERICAN SAMOA|AS|US
ARIZONA|AZ|US
ARKANSAS|AR|US
CALIFORNIA|CA|US
COLORADO|CO|US
CONNECTICUT|CT|US
DELAWARE|DE|US
DISTRICT OF COLUMBIA|DC|US
FEDERATED STATES OF MICRONESIA|FM|US
FLORIDA|FL|US
GEORGIA|GA|US
GUAM|GU|US
HAWAII|HI|US
IDAHO|ID|US
ILLINOIS|IL|US
INDIANA|IN|US
IOWA|IA|US
KANSAS|KS|US
KENTUCKY|KY|US
LOUISIANA|LA|US
MAINE|ME|US
MARSHALL ISLANDS|MH|US
MARYLAND|MD|US
MASSACHUSETTS|MA|US
MICHIGAN|MI|US
MINNESOTA|MN|US
MISSISSIPPI|MS|US
MISSOURI|MO|US
MONTANA|MT|US
NEBRASKA|NE|US
NEVADA|NV|US
NEW HAMPSHIRE|NH|US
NEW JERSEY|NJ|US
NEW MEXICO|NM|US
NEW YORK|NY|US
NORTH CAROLINA|NC|US
NORTH DAKOTA|ND|US
NORTHERN MARIANA ISLANDS|MP|US
OHIO|OH|US
OKLAHOMA|OK|US
OREGON|OR|US
PALAU|PW|US
PENNSYLVANIA|PA|US
PUERTO RICO|PR|US
RHODE ISLAND|RI|US
SOUTH CAROLINA|SC|US
SOUTH DAKOTA|SD|US
TENNESSEE|TN|US
TEXAS|TX|US
UTAH|UT|US
VERMONT|VT|US
VIRGIN ISLANDS|VI|US
VIRGINIA|VA|US
WASHINGTON|WA|US
WEST VIRGINIA|WV|US
WISCONSIN|WI|US
WYOMING|WY|US